0,1,2,3,4,5,6,7,8,9,10,11,12,13,14,15,16,17,18,19,20,21,22,23,24,25,26,27,34,34,34,31,32,33,34,35,36,37,38,39,40,41,42,43,44,45,46,47,48,49,50,51,52,53,54,55,56
57,58,59,60,61,62,63,64,65,66,67,68,69,70,71,72,73,74,75,76,77,78,79,80,410,411,83,84,411,411,87,88,89,90,91,92,93,94,95,96,97,98,99,100,101,102,103,104,105,106,107,108,109,110,111,112,113
114,115,116,117,118,119,120,121,122,123,124,125,126,188,188,129,130,131,132,133,134,135,136,137,510,396,140,397,397,143,144,411,411,412,148,149,150,151,152,153,154,155,156,157,158,159,160,161,162,163,164,165,166,167,168,169,170
171,172,173,174,175,176,177,178,179,180,181,182,183,266,266,186,188,188,189,190,191,192,193,194,195,419,197,419,419,200,397,202,398,510,205,206,207,208,209,210,211,212,213,214,215,216,217,218,219,220,221,222,223,224,225,226,227
228,229,230,231,232,233,234,235,236,237,238,239,240,241,242,243,266,266,246,247,248,249,250,251,252,419,254,255,256,419,419,259,260,261,433,263,411,265,266,267,268,269,270,271,272,273,274,275,276,277,278,279,280,281,282,283,284
285,286,287,288,289,290,291,266,266,294,295,296,297,298,299,300,301,302,303,304,305,306,307,418,309,310,311,312,313,314,419,419,419,318,319,320,321,508,411,324,325,326,327,328,329,330,331,332,333,334,335,336,337,338,339,340,341
342,343,344,345,346,347,348,266,266,351,352,353,354,355,356,357,358,359,360,361,362,363,364,418,366,367,368,369,370,371,372,419,419,375,376,377,378,508,508,381,382,383,384,385,386,387,388,389,390,391,392,393,394,395,396,397,398
399,400,401,402,403,404,405,406,407,408,409,410,411,412,413,414,415,416,417,418,419,420,421,422,423,424,425,426,427,428,429,430,431,432,433,434,433,436,433,438,439,440,441,442,443,444,445,446,447,448,449,450,451,452,453,454,455
456,457,458,459,460,461,462,463,464,465,466,467,468,469,470,471,472,473,264,475,476,477,478,433,480,481,482,483,484,485,486,487,488,489,490,491,492,493,494,495,496,497,498,499,500,501,502,503,504,505,506,507,508,509,510,511,512
513,514,515,516,517,518,519,520,521,522,523,524,525,264,527,528,264,530,531,532,533,534,535,536,537,433,539,540,541,542,433,544,545,546,547,433,549,550,551,552,553,554,555,556,557,558,559,560,561,562,563,564,565,566,567,568,569
570,571,572,573,574,575,576,577,578,579,580,581,582,264,584,585,586,587,588,589,590,591,592,593,594,595,596,597,598,599,600,601,602,603,604,605,606,607,608,609,610,611,612,613,614,615,616,617,618,619,620,621,622,623,624,625,626
627,628,629,630,631,632,633,634,635,636,637,638,639,640,264,642,643,644,645,646,647,648,649,650,651,652,653,654,655,656,657,658,659,660,661,662,663,664,665,666,667,668,669,670,671,672,673,674,675,676,677,678,679,680,681,682,683
684,685,686,687,688,689,690,691,692,693,694,695,696,697,264,264,700,701,702,703,704,188,457,707,708,709,458,458,458,713,714,715,457,458,718,719,720,458,722,459,188,725,726,188,188,729,730,731,732,733,734,735,736,737,738,739,740
741,742,743,744,745,746,747,748,749,750,751,752,266,266,755,756,757,758,759,760,761,266,266,264,765,766,266,266,769,266,771,772,266,266,775,264,777,244,266,780,266,266,266,266,266,786,787,788,789,790,791,792,793,794,795,796,797
798,799,800,801,802,803,804,805,806,807,808,809,266,266,812,813,814,815,816,817,818,819,820,821,822,823,824,264,266,266,828,829,830,831,832,833,834,264,266,266,838,839,840,264,842,843,844,845,846,847,848,849,850,851,852,853,854
855,856,857,858,859,860,861,862,863,864,865,866,867,868,869,870,871,266,266,874,875,876,877,878,266,266,881,882,883,884,885,886,887,888,889,890,891,892,893,894,264,896,264,264,899,900,901,902,903,904,905,906,907,908,909,910,911
912,913,914,915,916,917,918,919,920,921,922,923,924,925,926,927,928,266,266,931,932,266,266,935,266,266,938,939,940,941,942,943,944,945,946,264,948,949,266,266,952,953,266,266,956,187,958,959,960,961,962,963,964,965,966,967,968
969,970,971,972,973,974,975,976,977,978,979,266,266,266,983,984,985,986,987,264,989,266,266,992,993,994,264,996,997,998,999,1000,266,266,1003,264,1005,1006,266,266,1009,1010,266,266,1013,264,1015,1016,1017,1018,1019,1020,1021,1022,1023,1024,1025
1026,1027,1028,1029,1030,1031,1032,1033,1034,1035,1036,266,266,266,1040,1041,1042,1043,1044,1045,1046,1047,1048,1049,1050,264,264,1053,1054,1055,1056,1057,266,266,1060,1061,1062,1063,1064,1065,1066,1067,1068,1069,264,264,264,187,188,1075,1076,1077,1078,1079,1080,1081,1082
1083,1084,1085,1086,1087,1088,1089,1090,1091,1092,1093,1094,1095,264,1097,1098,1099,1100,1101,1102,264,1104,264,1106,1107,1108,1109,264,1111,1112,1113,1114,1115,1116,1117,1118,1119,1120,264,264,1123,1124,1125,1126,1127,1128,1129,266,266,1132,1133,1134,1135,1136,1137,1138,1139
1140,1141,1142,1143,1144,1145,189,266,1148,1149,1150,1151,1152,1153,266,266,1156,1157,1158,1159,1160,1161,1162,1163,221,221,221,221,221,221,1170,1171,1172,1173,1174,264,1176,245,245,1179,1180,1181,1182,1183,1184,1185,1186,1187,1188,1189,1190,1191,1192,1193,1194,1195,1196
1197,1198,1199,1200,1201,1202,266,266,1205,1206,1207,264,1209,1210,266,266,1213,1214,264,1216,1217,266,266,266,266,266,264,265,1225,265,1227,1228,1229,1230,1231,264,264,245,245,1236,1237,1238,1239,1240,1241,1242,1243,1244,1245,1246,1247,1248,1249,1250,1251,1252,1253
1254,1255,1256,1257,1258,1259,1260,1261,264,1263,1264,1265,1266,1267,1268,1269,1270,1271,1272,1273,1274,266,266,266,1278,264,1280,265,265,264,1284,1285,1286,1287,1288,1289,1290,1291,1292,1293,1294,1295,1296,245,245,1299,1300,1301,1302,1303,1304,1305,1306,1307,1308,1309,1310
1311,1312,1313,1314,1315,1316,1317,1318,1319,1320,266,266,1323,1324,1325,1326,1327,264,1329,1330,1331,266,266,1334,1335,268,268,268,268,268,268,1342,228,228,1345,1346,1347,1348,1349,1350,1351,1352,1353,245,245,1356,1357,1358,1359,1360,1361,1362,1363,1364,1365,1366,1367
1368,1369,1370,1371,1372,1373,1374,1375,1376,1377,266,266,264,264,264,1383,1384,1385,1386,1387,1388,1389,264,1391,1392,268,268,265,1396,268,268,1399,268,268,268,1403,1404,267,267,1407,1408,1409,1410,1411,1412,1413,1414,1415,1416,1417,1418,1419,1420,1421,1422,1423,1424
1425,1426,1427,1428,1429,1430,1431,1432,1433,264,264,264,264,1438,1439,264,1441,264,1443,1444,1445,1446,1447,268,268,268,268,268,1453,264,1455,1456,1457,268,268,1460,1461,267,267,267,1465,1466,1467,1468,1469,1470,1471,1472,1473,1474,1475,1476,1477,1478,1479,1480,1481
1482,1483,1484,1485,1486,1487,1488,1489,1490,1491,1492,1493,1494,1495,1496,1497,1498,1499,1500,1501,1502,1503,1504,268,268,264,268,268,1510,1511,265,265,1514,1515,1516,1517,1518,1519,267,267,267,1523,1524,1525,1526,1527,1528,1529,1530,1531,1532,1533,1534,1535,1536,1537,1538
1539,1540,1541,1542,1543,1544,1545,266,266,1548,1549,1550,266,266,1553,1554,1555,1556,1557,1558,1559,268,268,268,264,1564,1565,1566,264,1568,265,265,265,265,1573,1574,1575,1576,1577,1578,267,267,1581,264,1583,1584,1585,1586,1587,1588,1589,1590,1591,1592,1593,1594,1595
1596,1597,1598,1599,1600,1601,1602,266,266,266,264,1607,266,266,1610,1611,1612,1613,1614,1615,1616,268,268,268,268,268,268,268,1624,1625,264,265,265,265,1630,198,199,1633,1634,1635,267,267,1638,1639,264,244,1642,1643,1644,1645,1646,1647,1648,1649,1650,1651,1652
1653,1654,1655,1656,1657,1658,1659,1660,1661,1662,264,264,1665,1666,1667,1668,1669,1670,1671,1672,1673,1674,268,268,1677,268,268,268,1681,265,265,265,265,1686,1687,244,244,1690,1691,1692,1693,1694,1695,1696,268,264,1699,1700,1701,1702,1703,1704,1705,1706,1707,1708,1709
1710,1711,1712,1713,1714,1715,1716,1717,1718,1719,1720,264,264,1723,1724,1725,1726,1727,1728,1729,1730,1731,264,268,268,264,1736,264,264,265,265,1741,265,265,264,1745,264,1747,1748,1749,1750,1751,1752,1753,1754,1755,1756,1757,1758,1759,1760,1761,1762,1763,1764,1765,1766
1767,1768,1769,1770,1771,1772,1773,1774,1775,266,266,1778,264,266,1781,1782,1783,1784,1785,1786,1787,1788,1789,1790,1791,1792,264,265,265,1796,1797,1798,265,265,1801,244,265,1804,1805,1806,1807,1808,1809,1810,1811,1812,1813,1814,1815,1816,1817,1818,1819,1820,1821,1822,1823
1824,1825,1826,1827,1828,1829,1830,1831,1832,266,266,1835,266,266,1838,1839,1840,1841,264,1843,1844,1845,1846,1847,1848,264,1850,265,265,265,1854,265,265,1857,1858,244,244,1861,1862,1863,1864,1865,1866,1867,1868,1869,1870,1871,1872,1873,1874,1875,1876,1877,1878,1879,1880
1881,1882,1883,1884,1885,1886,1887,1888,1889,1890,1891,264,1893,1894,1895,264,1897,1898,264,1900,264,1902,1903,1904,1905,1906,1907,1908,1909,1910,1911,265,265,1914,1915,1916,264,1918,1919,1920,1921,1922,1923,1924,1925,1926,1927,1928,1929,1930,1931,1932,1933,1934,1935,1936,1937
1938,1939,1940,1941,1942,1943,1944,1945,1946,1947,1948,1949,1950,1951,1952,244,244,1955,1956,1957,1958,1959,1960,244,244,1963,1964,1965,1966,1967,1968,1969,1970,1971,1972,1973,1974,1975,1976,1977,1978,1979,1980,1981,1982,1983,1984,1985,1986,1987,1988,1989,1990,1991,1992,1993,1994
1995,1996,1997,1998,1999,2000,2001,2002,2003,2004,2005,2006,2007,2008,2009,1276,244,2012,264,2014,2015,2016,2017,244,244,2020,2021,2022,264,264,264,2026,2027,2028,2029,2030,2031,2032,2033,2034,2035,2036,2037,2038,2039,2040,2041,2042,23,23,23,2046,2047,2048,2049,2050,2051
2052,2053,2054,2055,2056,2057,2058,2059,2060,2061,2062,2063,2064,2065,2066,2067,2068,264,264,244,244,244,2074,264,244,244,2078,2079,264,264,2082,2083,2084,2085,2086,2087,2088,2089,2090,2091,2092,2093,2094,2095,2096,2097,2098,23,23,2101,23,2103,2104,2105,2106,2107,2108
2109,2110,2111,2112,2113,2114,2115,2116,2117,2118,2119,2120,2121,2122,2123,2124,2125,264,244,244,264,244,264,2132,264,2134,244,244,264,2138,2139,2140,2141,2142,2143,2144,2145,2146,2147,2148,2149,2150,2151,2152,2153,2154,23,-1,-1,23,23,2160,2161,2162,2163,2164,2165
2166,2167,2168,2169,2170,2171,2172,2173,2174,2175,2176,2177,2178,2179,264,2181,2182,264,244,244,1500,264,244,2189,2190,264,244,264,2194,2195,2196,2197,2198,2199,2200,2201,2202,2203,2204,2205,2206,2207,2208,2209,2210,2211,23,23,23,23,23,2217,2218,2219,2220,2221,2222
2223,2224,2225,2226,2227,2228,2229,2230,2231,2232,2233,2234,2235,2236,264,2238,2239,2240,244,2242,1557,244,244,264,264,2248,264,2250,2251,2252,2253,2254,2255,2256,2257,27,2259,2260,2261,2262,2263,2264,2265,2266,2267,2268,2269,2270,2271,2272,2273,2274,2275,2276,2277,2278,2279
2280,2281,2282,2283,2284,2285,2286,2287,2288,2289,2290,2291,2292,2293,2294,264,2296,2297,2298,244,264,264,264,2303,2304,2305,2306,2307,2308,2309,2310,2311,2312,2313,2314,2315,2316,2317,2318,2319,2320,2321,23,23,2324,2325,2326,2327,2328,2329,23,23,2332,2333,2334,2335,2336
2337,2338,2339,2340,2341,2342,2343,2344,2345,2346,2347,2348,2349,2350,2351,145,264,2354,264,264,264,264,264,2360,2361,2362,2363,2364,2365,2366,2367,2368,2369,2370,2371,2372,2373,2374,2375,2376,2377,2378,23,23,2381,2382,2383,2384,2385,23,23,23,2389,2390,2391,2392,2393
2394,2395,2396,2397,2398,2399,2400,2401,2402,2403,2404,2405,2406,2407,2408,2409,2410,264,264,2413,2414,2415,264,2417,2418,2419,2420,2421,2422,2423,2424,2425,57,23,2428,2429,2430,2431,2432,2433,23,2435,2436,2437,2438,2439,2440,2441,2442,23,2444,2445,2446,2447,2448,2449,2450
2451,2452,2453,2454,2455,2456,2457,2458,2459,2460,2461,2462,2463,2464,2465,2466,2467,2468,2469,2470,2471,2472,2473,2474,2475,2476,2477,2478,2479,2480,2481,2482,23,23,2485,2486,2487,2488,2489,2490,2491,2492,2493,2494,2495,2496,2497,2498,2499,2500,23,2502,2503,2504,2505,2506,2507
2508,2509,2510,2511,2512,2513,2514,2515,2516,2517,2518,2519,2520,2521,2522,2523,2524,2525,2526,2527,2528,2529,2530,2531,2532,2533,2534,2535,2536,2537,57,23,23,23,2542,2543,2544,2545,23,2547,2548,2549,2550,2551,2552,2553,2554,2555,2556,2557,2558,2559,2560,2561,2562,2563,2564
2565,2566,2567,2568,2569,2570,2571,2572,2573,2574,2575,2576,2577,2578,2579,2580,2581,2582,2583,2584,2585,2586,2587,2588,2589,2590,2591,2592,2593,2594,23,23,2597,2598,2599,23,2601,2602,2603,2604,2605,2606,2607,2608,2609,2610,1,23,23,2614,2615,2616,2617,2618,2619,2620,2621
2622,2623,2624,2625,2626,2627,2628,2629,2630,2631,2632,2633,2634,2635,2636,2637,2638,2639,2640,2641,2642,2643,2644,2645,2646,2647,2648,2649,2650,2651,2652,2653,2654,2655,2656,2657,2658,2659,2660,2661,2662,2663,2664,2665,2666,23,23,23,2670,2671,2672,2673,2674,2675,2676,2677,2678
2679,2680,2681,2682,2683,2684,2685,2686,2687,2688,2689,2690,2691,2692,2693,2694,2695,2696,2697,2698,2699,2700,2701,2702,2703,2704,2705,2706,2707,2708,2709,2710,2711,2712,2713,2714,2715,2716,2717,2718,2719,2720,2721,2722,2723,2724,2725,2726,2727,2728,2729,2730,2731,2732,2733,2734,2735
2736,2737,2738,2739,2740,2741,2742,2743,2744,2745,2746,2747,2748,2749,2750,2751,2752,2753,2754,2755,2756,2757,2758,2759,2760,2761,2762,2763,2764,2765,2766,2767,2768,2769,2770,2771,2772,2773,2774,2775,2776,2777,2778,2779,2780,2781,2782,2783,2784,2785,2786,2787,2788,2789,2790,2791,2792
2793,2794,2795,2796,2797,2798,2799,2800,2801,2802,2803,2804,2805,2806,2807,2808,2809,2810,2811,2812,2813,2814,2815,2816,2817,2818,2819,2820,2821,2822,2823,2824,2825,2826,2827,2828,2829,2830,2831,2832,2833,2834,2835,2836,2837,2838,2839,2840,2841,2842,2843,2844,2845,2846,2847,2848,2849
